10 10
##########
#........#
#........#
#...#.S..#
#...#.H..#
#...#.H..#
#....F...#
#..F.....#
#........#
##########
1 1
1 8
8 1
8 8
5 5 5
4
6 3
6 4
5 3
7 5
4
1 1
1 8
8 1
8 8
4
2 2
2 7
8 2
7 7
2
3 6 4 6
3 6 5 6